World	xx-flag.gif
Afghanistan	af-flag.gif
Akrotiri	ax-flag.gif
Albania	al-flag.gif
Algeria	ag-flag.gif
American Samoa	aq-flag.gif
Andorra	an-flag.gif
Angola	ao-flag.gif
Anguilla	av-flag.gif
Antarctica	ay-flag.gif
Antigua and Barbuda	ac-flag.gif
Arctic Ocean	xq-flag.gif
Argentina	ar-flag.gif
Armenia	am-flag.gif
Aruba	aa-flag.gif
Ashmore and Cartier Islands	at-flag.gif
Atlantic Ocean	zh-flag.gif
Australia	as-flag.gif
Austria	au-flag.gif
Azerbaijan	aj-flag.gif
Bahamas,The	bf-flag.gif
Bahrain	ba-flag.gif
Baker Island	fq-flag.gif
Bangladesh	bg-flag.gif
Barbados	bb-flag.gif
Bassasda India	bs-flag.gif
Belarus	bo-flag.gif
Belgium	be-flag.gif
Belize	bh-flag.gif
Benin	bn-flag.gif
Bermuda	bd-flag.gif
Bhutan	bt-flag.gif
Bolivia	bl-flag.gif
Bosnia and Herzegovina	bk-flag.gif
Botswana	bc-flag.gif
Bouvet Island	bv-flag.gif
Brazil	br-flag.gif
British Indian Ocean Territory	io-flag.gif
British Virgin Islands	vi-flag.gif
Brunei	bx-flag.gif
Bulgaria	bu-flag.gif
Burkina Faso	uv-flag.gif
Burma	bm-flag.gif
Burundi	by-flag.gif
Cambodia	cb-flag.gif
Cameroon	cm-flag.gif
Canada	ca-flag.gif
Cape Verde	cv-flag.gif
Cayman Islands	cj-flag.gif
Central African Republic	ct-flag.gif
Chad	cd-flag.gif
Chile	ci-flag.gif
China	ch-flag.gif
Christmas Island	kt-flag.gif
Clipperton Island	ip-flag.gif
Cocos(Keeling)Islands	ck-flag.gif
Colombia	co-flag.gif
Comoros	cn-flag.gif
Congo,Democratic Republicofthe	cg-flag.gif
Congo,Republicofthe	cf-flag.gif
Cook Islands	cw-flag.gif
Coral Sea Islands	cr-flag.gif
Costa Rica	cs-flag.gif
Coted'Ivoire	iv-flag.gif
Croatia	hr-flag.gif
Cuba	cu-flag.gif
Cyprus	cy-flag.gif
Czech Republic	ez-flag.gif
Denmark	da-flag.gif
Dhekelia	dx-flag.gif
Djibouti	dj-flag.gif
Dominica	do-flag.gif
Dominican Republic	dr-flag.gif
East Timor	tt-flag.gif
Ecuador	ec-flag.gif
Egypt	eg-flag.gif
El Salvador	es-flag.gif
Equatorial Guinea	ek-flag.gif
Eritrea	er-flag.gif
Estonia	en-flag.gif
Ethiopia	et-flag.gif
Europa Island	eu-flag.gif
Falkland Islands(Islas Malvinas)	fk-flag.gif
Faroe Islands	fo-flag.gif
Fiji	fj-flag.gif
Finland	fi-flag.gif
France	fr-flag.gif
French Polynesia	fp-flag.gif
French Southern and Antarctic Lands	fs-flag.gif
Gabon	gb-flag.gif
Gambia,The	ga-flag.gif
Gaza Strip	gz-flag.gif
Georgia	gg-flag.gif
Germany	gm-flag.gif
Ghana	gh-flag.gif
Gibraltar	gi-flag.gif
Glorioso Islands	go-flag.gif
Greece	gr-flag.gif
Greenland	gl-flag.gif
Grenada	gj-flag.gif
Guam	gq-flag.gif
Guatemala	gt-flag.gif
Guernsey	gk-flag.gif
Guinea	gv-flag.gif
Guinea-Bissau	pu-flag.gif
Guyana	gy-flag.gif
Haiti	ha-flag.gif
Heard Island and Mc Donald Islands	hm-flag.gif
Holy See(Vatican City)	vt-flag.gif
Honduras	ho-flag.gif
Hong Kong	hk-flag.gif
Howland Island	hq-flag.gif
Hungary	hu-flag.gif
Iceland	ic-flag.gif
Iles Eparses	zz-flag.gif
India	in-flag.gif
Indian Ocean	xo-flag.gif
Indonesia	id-flag.gif
Iran	ir-flag.gif
Iraq	iz-flag.gif
Ireland	ei-flag.gif
Isleof Man	im-flag.gif
Israel	is-flag.gif
Italy	it-flag.gif
Jamaica	jm-flag.gif
Jan Mayen	jn-flag.gif
Japan	ja-flag.gif
Jarvis Island	dq-flag.gif
Jersey	je-flag.gif
Johnston Atoll	jq-flag.gif
Jordan	jo-flag.gif
Juande Nova Island	ju-flag.gif
Kazakhstan	kz-flag.gif
Kenya	ke-flag.gif
Kingman Reef	kq-flag.gif
Kiribati	kr-flag.gif
Korea,North	kn-flag.gif
Korea,South	ks-flag.gif
Kuwait	ku-flag.gif
Kyrgyzstan	kg-flag.gif
Laos	la-flag.gif
Latvia	lg-flag.gif
Lebanon	le-flag.gif
Lesotho	lt-flag.gif
Liberia	li-flag.gif
Libya	ly-flag.gif
Liechtenstein	ls-flag.gif
Lithuania	lh-flag.gif
Luxembourg	lu-flag.gif
Macau	mc-flag.gif
Macedonia	mk-flag.gif
Madagascar	ma-flag.gif
Malawi	mi-flag.gif
Malaysia	my-flag.gif
Maldives	mv-flag.gif
Mali	ml-flag.gif
Malta	mt-flag.gif
Marshall Islands	rm-flag.gif
Mauritania	mr-flag.gif
Mauritius	mp-flag.gif
Mayotte	mf-flag.gif
Mexico	mx-flag.gif
Micronesia,Federated Statesof	fm-flag.gif
Midway Islands	mq-flag.gif
Moldova	md-flag.gif
Monaco	mn-flag.gif
Mongolia	mg-flag.gif
Montenegro	mj-flag.gif
Montserrat	mh-flag.gif
Morocco	mo-flag.gif
Mozambique	mz-flag.gif
Namibia	wa-flag.gif
Nauru	nr-flag.gif
Navassa Island	bq-flag.gif
Nepal	np-flag.gif
Netherlands	nl-flag.gif
Netherlands Antilles	nt-flag.gif
New Caledonia	nc-flag.gif
New Zealand	nz-flag.gif
Nicaragua	nu-flag.gif
Niger	ng-flag.gif
Nigeria	ni-flag.gif
Niue	ne-flag.gif
Norfolk Island	nf-flag.gif
Northern Mariana Islands	cq-flag.gif
Norway	no-flag.gif
Oman	mu-flag.gif
Pacific Ocean	zn-flag.gif
Pakistan	pk-flag.gif
Palau	ps-flag.gif
Palmyra Atoll	lq-flag.gif
Panama	pm-flag.gif
Papua New Guinea	pp-flag.gif
Paracel Islands	pf-flag.gif
Paraguay	pa-flag.gif
Peru	pe-flag.gif
Philippines	rp-flag.gif
Pitcairn Islands	pc-flag.gif
Poland	pl-flag.gif
Portugal	po-flag.gif
Puerto Rico	rq-flag.gif
Qatar	qa-flag.gif
Romania	ro-flag.gif
Russia	rs-flag.gif
Rwanda	rw-flag.gif
Saint Helena	sh-flag.gif
Saint Kitts and Nevis	sc-flag.gif
Saint Lucia	st-flag.gif
Saint Pierre and Miquelon	sb-flag.gif
Saint Vincentandthe Grenadines	vc-flag.gif
Samoa	ws-flag.gif
San Marino	sm-flag.gif
Sao Tome and Principe	tp-flag.gif
Saudi Arabia	sa-flag.gif
Senegal	sg-flag.gif
Serbia	rb-flag.gif
Seychelles	se-flag.gif
Sierra Leone	sl-flag.gif
Singapore	sn-flag.gif
Slovakia	lo-flag.gif
Slovenia	si-flag.gif
Solomon Islands	bp-flag.gif
Somalia	so-flag.gif
South Africa	sf-flag.gif
South Georgiaandthe South Sandwich Islands	sx-flag.gif
Southern Ocean	oo-flag.gif
Spain	sp-flag.gif
Spratly Islands	pg-flag.gif
Sri Lanka	ce-flag.gif
Sudan	su-flag.gif
Suriname	ns-flag.gif
Svalbard	sv-flag.gif
Swaziland	wz-flag.gif
Sweden	sw-flag.gif
Switzerland	sz-flag.gif
Syria	sy-flag.gif
Tajikistan	ti-flag.gif
Tanzania	tz-flag.gif
Thailand	th-flag.gif
Togo	to-flag.gif
Tokelau	tl-flag.gif
Tonga	tn-flag.gif
Trinidad and Tobago	td-flag.gif
Tromelin Island	te-flag.gif
Tunisia	ts-flag.gif
Turkey	tu-flag.gif
Turkmenistan	tx-flag.gif
Turks and Caicos Islands	tk-flag.gif
Tuvalu	tv-flag.gif
Uganda	ug-flag.gif
Ukraine	up-flag.gif
United Arab Emirates	ae-flag.gif
United Kingdom	uk-flag.gif
United States	us-flag.gif
United States Pacific Island Wildlife Refuges	um-flag.gif
Uruguay	uy-flag.gif
Uzbekistan	uz-flag.gif
Vanuatu	nh-flag.gif
Venezuela	ve-flag.gif
Vietnam	vm-flag.gif
Virgin Islands	vq-flag.gif
Wake Island	wq-flag.gif
Wallis and Futuna	wf-flag.gif
West Bank	we-flag.gif
Western Sahara	wi-flag.gif
Yemen	ym-flag.gif
Zambia	za-flag.gif
Zimbabwe	zi-flag.gif
Taiwan	tw-flag.gif
European Union	ee-flag.gif
